1111111111
0011111111
1011111111
1011111111
1011111111
1000011111
1111011111
1111000001
1111111100
1111111111
